###############
#FFFFFF#FFFFFF#
#F##F#F#F#F##F#
#F##F#F#F#F##F#
#FFFFFFFFFFFFF#
####F#F########
#####F#FFFF####
####F#F##F#####
####F#F##F#####
####FFFFFF#####
#####FGGGF#####
#####FFFFF#####
###############
###############
###############
###############
###############
###############
###############
###############
