###############
#F.....#.....F#
#.##.#.#.#.##.#
#.##.#.#.#.##.#
#.............#
#.##.#.##.###.#
#....#....#...#
####.#.##.#.###
####........###
####.##0##.####
####.#0G0#.####
####.#####.####
#......P.....##
#.##.#.#####.##
#..#...###....#
##.#.#.###.##.#
#....#.....##.#
#.#####.#####.#
#F...........F#
###############
